%%%%%%%%%%
%   K%%%S%
% O     SE
%      A%%
%%%%%%%%%%
