%%%%%%%%%%%%%%%%%%%%%%%%%%%%%%%%%%%%%%%%%%%%%%%%%%%%%%%%%%%%%%%%%%%%% %
% %     %     %     %       % %
% % %%%%%%%%% % %%%%% %%%%%%%%% %%%%% %%%%% %%%%% % %
%     %   % %     %     % % %   % %
%%%%%%%%% % %%%%%%%%% %%%%%%%%% %%%%% % % % %%%%%%%%% %
%   % %     %     % % % % %     % %
% % %%%%%%%%%%%%% % % %%%%%%%%% %%%%% % %%%%%%%%% % %
% %     % % %   %     %     %   % %
% %%%%%%%%%%%%% %%%%% %%%%% % %%%%% %%%%%%%%% % %%%%% %
%     %   % %   % %   %     % %     %
% %%%%% %%%%% % %%%%% % %%%%%%%%% % % % %%%%%%%%%%%%%
%   %   % % %   %   %   % % %   %   %
%%%%%%%%%%%%% % % % %%%%%%%%% % %%%%% % %%%%% %%%%% %
%     % %     %   % %   % %   %     %
% %%%%% % %%%%%%%%% %%%%% % %%%%% %%%%% %%%%%%%%%%%%% %
% %   %     %     %   % % %     % %
% % %%%%%%%%% % %%%%% %%%%%%%%% % % %%%%%%%%%%%%% % %
% %     % % % % %     %     % %   %
% %%%%%%%%% % % % %%%%% %%%%%%%%% %%%%%%%%% % %%%%%%%%%
% %   % % %     %     % %   %     %
% % %%%%% %%%%% %%%%% %%%%%%%%% %%%%% % %%%%%%%%% % %
% %       %     %     %     % %
% %%%%%%%%%%%%%%%%%%%%%%%%%%%%%%%%%%%%%%%%%%%%%%%%%%%%%%%%%%%%%%%%%%%%%